#######################################
# Syntax Coloring Map For WaveshareESP32S3
#######################################

#######################################
# Datatypes (KEYWORD1)
#######################################

WaveshareESP32S3	KEYWORD1
WaveshareDisplay	KEYWORD1
WaveshareTouch	KEYWORD1
TouchPoint	KEYWORD1

#######################################
# Methods and Functions (KEYWORD2)
#######################################

begin	KEYWORD2
end	KEYWORD2
beginBasic	KEYWORD2
printInfo	KEYWORD2
testAll	KEYWORD2
bootButtonPressed	KEYWORD2
isInitialized	KEYWORD2
getVersion	KEYWORD2

# Display methods
clear	KEYWORD2
power	KEYWORD2
setBrightness	KEYWORD2
getBrightness	KEYWORD2
increaseBrightness	KEYWORD2
decreaseBrightness	KEYWORD2
setRotation	KEYWORD2
getRotation	KEYWORD2
drawPixel	KEYWORD2
drawLine	KEYWORD2
drawRect	KEYWORD2
fillRect	KEYWORD2
drawCircle	KEYWORD2
fillCircle	KEYWORD2
drawTriangle	KEYWORD2
fillTriangle	KEYWORD2
drawRoundRect	KEYWORD2
fillRoundRect	KEYWORD2
setTextColor	KEYWORD2
setTextSize	KEYWORD2
setCursor	KEYWORD2
print	KEYWORD2
println	KEYWORD2
drawBitmap	KEYWORD2
drawRGBBitmap	KEYWORD2
width	KEYWORD2
height	KEYWORD2
color565	KEYWORD2
getGFX	KEYWORD2

# Touch methods
read	KEYWORD2
touched	KEYWORD2
getPoint	KEYWORD2
getX	KEYWORD2
getY	KEYWORD2
calibrate	KEYWORD2

#######################################
# Constants (LITERAL1)
#######################################

# Colors
COLOR_BLACK	LITERAL1
COLOR_WHITE	LITERAL1
COLOR_RED	LITERAL1
COLOR_GREEN	LITERAL1
COLOR_BLUE	LITERAL1
COLOR_YELLOW	LITERAL1
COLOR_CYAN	LITERAL1
COLOR_MAGENTA	LITERAL1
COLOR_ORANGE	LITERAL1
COLOR_PURPLE	LITERAL1
COLOR_GRAY	LITERAL1
COLOR_LIGHT_GRAY	LITERAL1
COLOR_DARK_GRAY	LITERAL1
COLOR_SPARKOH_BLUE	LITERAL1
COLOR_SPARKOH_GREEN	LITERAL1
COLOR_SPARKOH_ORANGE	LITERAL1

# Features
FEATURE_DISPLAY_ENABLED	LITERAL1
FEATURE_TOUCH_ENABLED	LITERAL1
FEATURE_AUDIO_ENABLED	LITERAL1
FEATURE_IMU_ENABLED	LITERAL1
FEATURE_RTC_ENABLED	LITERAL1
FEATURE_SD_CARD_ENABLED	LITERAL1
FEATURE_CAMERA_ENABLED	LITERAL1
FEATURE_WIFI_ENABLED	LITERAL1
FEATURE_BLUETOOTH_ENABLED	LITERAL1

# Pins
LCD_WIDTH	LITERAL1
LCD_HEIGHT	LITERAL1
BTN_BOOT	LITERAL1
